-R-G-R-R-R-R-R-R-R-R-R-R-R-R-R-R-R-R-R-R-R-R
-G-G-G-G-G-G-G-G-G-G-R-R-R-R-R-R-R-R-R-R-R-R
-G-G-G-G-G-G-G-G-G-G-R-R-R-R-R-R-R-R-R-R-R-R
-G-G-G-R-G-G-G-G-G-G-G-G-G-G-G-G-G-G-G-G-G-R
-G-G-G-R-G-G-G-G-G-G-G-G-G-G-G-G-G-G-G-G-G-R
-G-G-G-R-G-G-G-G-G-G-G-G-G-G-G-G-G-G-G-G-G-R
-G-G-G-R-G-G-G-G-G-G-G-G-G-G-G-G-G-G-G-G-G-R
-G-G-G-R-G-G-G-G-G-G-G-G-G-G-G-G-G-G-G-G-G-R
-G-G-G-R-G-R-R-G-G-G-R-R-R-R-R-R-R-R-R-G-R-R
-G-G-G-R-G-G-R-G-G-G-R-R-R-R-R-R-R-R-R-G-R-R
-G-G-G-R-R-R-R-G-G-G-R-R-R-R-R-R-R-R-R-G-R-R
-G-G-G-G-G-G-G-G-G-G-G-G-G-G-G-G-G-G-G-G-G-G
-R-R-R-R-R-R-R-R-R-R-R-R-R-R-R-R-R-R-R-R-R-R